W	W	W	W	W	W	W	W	W	W	W	W	W	W	W	W	W	W	W	W	W	W	W	W	W	W	W	W	W	W	W	W	W	W	W	W	W	W	W	W	W
S	C	C	C	W	C	C	C	C	C	C	C	C	C	W	C	C	C	W	C	C	C	C	C	W	C	C	C	C	C	C	C	C	C	W	C	W	C	C	C	W
W	C	W	W	W	C	W	W	W	C	W	W	W	C	W	C	W	C	W	W	W	W	W	C	W	C	W	W	W	W	W	C	W	C	W	C	W	C	W	C	W
W	C	C	C	W	C	C	C	W	C	C	C	W	C	W	C	W	C	C	C	C	C	W	C	W	C	C	C	W	C	C	C	W	C	W	C	C	C	W	C	W
W	W	W	C	W	W	W	C	W	W	W	C	W	W	W	C	W	W	W	W	W	C	W	C	W	C	W	W	W	C	W	W	W	C	W	C	W	W	W	C	W
W	C	C	C	C	C	W	C	C	C	W	C	C	C	C	C	W	C	W	C	C	C	W	C	C	C	W	C	C	C	W	C	W	C	W	C	C	C	W	C	W
W	C	W	W	W	W	W	W	W	C	W	W	W	W	W	W	W	C	W	C	W	W	W	C	W	W	W	C	W	W	W	C	W	C	W	W	W	C	W	C	W
W	C	C	C	C	C	C	C	W	C	W	C	C	C	C	C	C	C	W	C	W	C	C	C	C	C	W	C	W	C	W	C	C	C	W	C	C	C	W	C	W
W	C	W	W	W	W	W	C	W	C	W	C	W	W	W	W	W	C	W	C	W	W	W	W	W	W	W	C	W	C	W	C	W	W	W	C	W	W	W	C	W
W	C	C	C	W	C	W	C	W	C	W	C	W	C	C	C	W	C	W	C	C	C	C	C	W	C	C	C	W	C	W	C	W	C	W	C	C	C	W	C	W
W	W	W	C	W	C	W	C	W	C	W	C	W	C	W	W	W	C	W	W	W	W	W	C	W	C	W	W	W	C	W	C	W	C	W	C	W	W	W	C	W
W	C	W	C	W	C	W	C	C	C	W	C	W	C	C	C	W	C	W	C	C	C	C	C	W	C	C	C	W	C	C	C	W	C	C	C	W	C	C	C	W
W	C	W	C	W	C	W	W	W	W	W	C	W	W	W	C	W	C	W	C	W	W	W	W	W	C	W	C	W	C	W	W	W	W	W	W	W	C	W	C	W
W	C	C	C	W	C	C	C	C	C	C	C	C	C	W	C	W	C	W	C	C	C	W	C	C	C	W	C	W	C	W	C	C	C	C	C	C	C	W	C	W
W	C	W	W	W	W	W	W	W	W	W	C	W	C	W	C	W	C	W	W	W	C	W	W	W	C	W	C	W	C	W	C	W	W	W	W	W	W	W	C	W
W	C	W	C	C	C	C	C	C	C	W	C	W	C	W	C	W	C	C	C	W	C	W	C	W	C	W	C	W	C	W	C	W	C	W	C	C	C	W	C	W
W	C	W	W	W	C	W	W	W	C	W	C	W	C	W	C	W	W	W	C	W	C	W	C	W	C	W	C	W	C	W	C	W	C	W	C	W	C	W	C	W
W	C	C	C	C	C	W	C	C	C	W	C	W	C	W	C	C	C	W	C	W	C	C	C	W	C	W	C	W	C	C	C	W	C	W	C	W	C	C	C	W
W	W	W	W	W	W	W	C	W	W	W	W	W	C	W	C	W	W	W	C	W	W	W	W	W	W	W	C	W	W	W	W	W	C	W	C	W	W	W	W	W
W	C	C	C	C	C	W	C	W	C	C	C	C	C	W	C	C	C	W	C	C	C	C	C	C	C	C	C	W	C	W	C	C	C	W	C	C	C	W	C	W
W	C	W	W	W	C	W	C	W	W	W	C	W	W	W	C	W	C	W	W	W	W	W	W	W	W	W	W	W	C	W	C	W	C	W	W	W	C	W	C	W
W	C	C	C	W	C	W	C	W	C	C	C	W	C	C	C	W	C	C	C	C	C	W	C	C	C	C	C	W	C	C	C	W	C	C	C	W	C	C	C	W
W	W	W	W	W	C	W	C	W	C	W	W	W	C	W	W	W	W	W	C	W	C	W	W	W	W	W	C	W	C	W	W	W	W	W	C	W	W	W	C	W
W	C	C	C	C	C	W	C	C	C	W	C	C	C	W	C	C	C	C	C	W	C	C	C	W	C	C	C	W	C	C	C	C	C	W	C	W	C	C	C	W
W	C	W	W	W	W	W	W	W	W	W	C	W	W	W	C	W	W	W	W	W	W	W	C	W	C	W	W	W	W	W	W	W	C	W	C	W	C	W	W	W
W	C	C	C	C	C	C	C	W	C	C	C	W	C	W	C	C	C	C	C	W	C	C	C	C	C	W	C	C	C	C	C	W	C	W	C	W	C	W	C	W
W	C	W	W	W	W	W	C	W	C	W	W	W	C	W	W	W	W	W	C	W	W	W	W	W	C	W	C	W	C	W	W	W	C	W	C	W	C	W	C	W
W	C	W	C	C	C	W	C	C	C	W	C	C	C	W	C	C	C	W	C	C	C	C	C	W	C	W	C	W	C	C	C	C	C	W	C	C	C	W	C	W
W	C	W	C	W	C	W	W	W	W	W	C	W	C	W	C	W	C	W	W	W	W	W	C	W	C	W	C	W	W	W	W	W	W	W	W	W	W	W	C	W
W	C	C	C	W	C	C	C	W	C	C	C	W	C	W	C	W	C	C	C	C	C	W	C	W	C	W	C	C	C	W	C	C	C	W	C	C	C	C	C	W
W	W	W	W	W	W	W	C	W	C	W	W	W	C	W	C	W	C	W	W	W	W	W	C	W	C	W	W	W	C	W	C	W	C	W	W	W	C	W	W	W
W	C	C	C	C	C	W	C	C	C	W	C	W	C	W	C	W	C	W	C	C	C	W	C	W	C	C	C	W	C	W	C	W	C	C	C	W	C	C	C	W
W	W	W	C	W	W	W	W	W	W	W	C	W	C	W	C	W	W	W	C	W	C	W	C	W	W	W	C	W	C	W	C	W	W	W	C	W	C	W	C	W
W	C	C	C	W	C	C	C	C	C	C	C	C	C	W	C	C	C	C	C	W	C	W	C	W	C	C	C	W	C	C	C	W	C	C	C	W	C	W	C	W
W	C	W	W	W	C	W	W	W	W	W	W	W	W	W	C	W	W	W	W	W	C	W	C	W	W	W	W	W	W	W	W	W	C	W	W	W	C	W	C	W
W	C	C	C	C	C	W	C	C	C	C	C	W	C	C	C	W	C	C	C	W	C	W	C	C	C	W	C	C	C	C	C	W	C	W	C	C	C	W	C	W
W	C	W	W	W	W	W	C	W	W	W	C	W	W	W	W	W	C	W	C	W	C	W	W	W	C	W	C	W	C	W	C	W	C	W	W	W	W	W	C	W
W	C	C	C	W	C	C	C	W	C	W	C	C	C	C	C	W	C	W	C	W	C	W	C	C	C	W	C	W	C	W	C	W	C	W	C	C	C	W	C	W
W	W	W	C	W	C	W	W	W	C	W	W	W	W	W	C	W	C	W	C	W	C	W	C	W	W	W	C	W	C	W	W	W	C	W	C	W	C	W	C	W
W	C	C	C	C	C	W	C	C	C	C	C	C	C	C	C	C	C	W	C	C	C	W	C	C	C	C	C	W	C	C	C	C	C	C	C	W	C	C	C	F
W	W	W	W	W	W	W	W	W	W	W	W	W	W	W	W	W	W	W	W	W	W	W	W	W	W	W	W	W	W	W	W	W	W	W	W	W	W	W	W  W
